111111111
100000001
100EPC001
100000001
111111111