1111111111111
10E0000000E01
100E00000E001
1000E000E0001
10000E0E00001
1000000000001
1000000000001
1000001010001
1000001N10001
1000001110001
1000000000001
1K0000HP00001
1111111111111
