1111111111
1E111C11P1
11011C1111
1000000001
1111111111